#####################
#@ # # # # #
### # ### ### # # # #
# # # # #
# ####### ##### ### #
# # # # # # # #
### # # ### ### # # #
# # # # # #
# # # ####### # # ###
# # # # # #
# # ##### # # # #####
# # # # # # # #
# # # # ##### ##### #
# # # # # # # #
# ### # # # # ##### #
# # # # # #
####### ####### #####
# # # # # # #
# # # ### ####### # #
# #
###################!#
